           #########################
           #              P        #
           #                       #
           #         O            #
           #          X            #
           #                       #
           #########################